a s d w w w w w w w w w w
w w w w w w w w w w w w w
g g g g g c g t g g g g g
f g g g g g g g g f g x g
g x g g g x g g g g g g g
g g f g g g g g g g g g g
g g g g g g f g g x g g g
g g x g f g g g g g g g x
g g g w w w x g f g g f g
a s s s s s s s s s s s d